#
#
#
#
#
#
#
#
#
#
#
#
#
#
#                                              #
#                                              #
#                                              # 
#                                              # 
#                                              # 
#######################  #######################
