#######################################
#                        #            #
#                        #            #
#                        #            #
#                        #            #
#                        #######      #
#                                     #
#                                     #
#                                     #
#                                     #
#                                     #
#                                     #
#      d        d                     #
#                                     #
#                                     #
#      d        d                     #
#                                     #
#                                     #
#                                     #
#                                     #
#                                     #
#                                     #
#                                     #
#                                     #
#                                     #
#                                     #
#                                     #
#                                     #
#                                     #
#                                     #
#                                     #
#                                     #
#                                     #
#                                     #
#                                     #
#                                     #
#                                     #
#                                     #
#                                     #
#######################################
